#########################
#S............#....#.####
#..##..#.##...###.......#
#.##.#.#..#...#..##...#.#
#..#.##..#.#.#.#..##....#
#....#..#...#...........#
#..#.#....#...#.##.....##
#.....#....##.#.....###.#
#...#........##.........#
###................#....#
#..#.....#.....#........#
#.#....#..#......##..#..#
##.#..#..###.........####
#.#.#..##.....###..#...##
##...###...#..#...#.#..##
#.....#.....#.##....#.#.#
#.##...#...##....#......#
#.##......#.#..#..#..#..#
#.##.#...##..#.#....#.###
#..#.....#....#..#.#....#
##..#.##.#....#..##.....#
#.....#.#.....#..#...#..#
#...###.##...#.#..##.#.##
#...#.#........###....#G#
#########################
