###############
#S............#
##....#.#.#..##
##....##...####
#........##.#.#
##......#..##.#
#..#...#.##...#
#.....#..#....#
#.....#..#...##
#.............#
##..........#.#
##............#
#.....##......#
#.###....#...G#
###############
