###############
#S#.....#.....#
#.#.###.###.#.#
#.#...#...#.#.#
#.###.###.#.#.#
#...#...#...#.#
###.#.#.#######
#...#.#.......#
#.###.#######.#
#.#.........#.#
#.###########.#
#.#...#.......#
#.#.#.#.#####.#
#...#...#....G#
###############
