#########
#S......#
#......##
#....#..#
#.#..##.#
#...##.G#
#########
