#########################
#S#.......#...#.........#
#.#.#####.#.#.#.###.#####
#.#.#.....#.#...#.#.#...#
#.###.#####.#####.#.#.#.#
#...#.#.....#.....#...#.#
###.#.#.#########.#####.#
#...#...#.........#.....#
#.###.###.#.#####.#.###.#
#.#...#...#.#.....#.#.#.#
#.#.#######.#.#####.#.#.#
#.#.#.....#.#.#.#...#...#
#.#.###.#.#.#.#.#.###.###
#.#.....#.#.#...#.#.#.#.#
#.#######.#.#####.#.#.#.#
#.....#.#.#.#.....#.....#
#####.#.#.#.#.#########.#
#.....#.....#...#...#.#.#
#.###########.#.#.#.#.#.#
#.....#.....#.#...#.#.#.#
#####.#.###.#.#####.#.#.#
#...#.#...#.#.....#.#.#.#
#.#.#.###.#.#######.#.#.#
#.#.......#.........#..G#
#########################
