#############################################################
#S#.........#...............#.......................#.......#
#.#.###.###.#####.#########.#.#######.#.#####.#######.#.#####
#.#...#...#.....#.#.#.....#.#.#.#...#.#...#...#...#...#.....#
#.#######.#####.#.#.#.###.#.#.#.#.#.#####.#####.#.#.#######.#
#...#.....#.#...#.#.....#.#.#...#.#.....#...#...#.....#...#.#
###.#.#####.#.###.#######.#.#####.#####.###.#.#########.#.#.#
#...#.....#.......#.......#.......#...#.....#.#.....#...#...#
#.###.###.#########.###.###########.#######.#.#####.#.#####.#
#.#.....#...#.......#...#.....#.............#.......#.....#.#
#.#.#######.#.###########.###.#.#################.#####.#.#.#
#.#...#.....#.............#.#...#...#.........#...#...#.#.#.#
#.###.#.#########.#########.#####.#.#.#######.#.###.#.#.#.###
#.#...#...#.....#.......#.....#.#.#...#.....#...#...#.#.#...#
#.#####.#.#.###.#######.#.###.#.#.#######.#.#####.###.#.###.#
#.....#.#.#.#...#.....#...#.....#.........#.#...#.#.#.#...#.#
#####.###.#.#.#####.#######.###############.#.#.#.#.#.#####.#
#.....#...#.#.....#.......#...#.............#.#.#.#.........#
#.#####.###.#####.###.###.#.###.###############.#.#########.#
#.....#.....#...#...#.#.#...#...#...........#...#.......#...#
#####.#.#####.#.###.#.#.#####.###.#########.#.#########.#.###
#...#.#.......#...#.#.......#.#.....#...#...#.........#.#...#
#.#.#.###########.#.#########.###.#.#.#.#.###.#####.#.#.#####
#.#...#.....#.....#.........#...#.#...#.#.#...#.....#.#.....#
#.#####.###.#.#############.###.#.#####.#.###.#.#####.#####.#
#.......#...#.#.....#.#...#...#.#.#.....#...#.#.#.........#.#
#########.###.###.#.#.#.#.###.#.#.#.#######.#.#.###########.#
#.#.......#.#...#.#...#.#.....#.#.#.#...#...#.#.#.........#.#
#.#.#######.###.#.#####.#####.#.###.#.#.###.###.#.#######.#.#
#.#.#.........#.#.#...#.#.....#...#.#.#...#.....#...#.....#.#
#.#.#.#.#####.#.#.#.#.#.#########.#.#.###.#.#######.#.#####.#
#.#.#.#.#...#.#.#.#.#.#...#.......#.....#.#.#.....#.#.#.....#
#.#.#.###.#.#.#.#.#.#.###.#.#############.#.#.###.#.#.#.###.#
#.#.#.....#.#.#...#.#.....#.#...........#.#.#...#...#...#.#.#
#.#.#.#####.#####.#.#######.#.#.#######.#.#.###.#########.#.#
#.#.#.#...#.....#.#...#.....#.#.#.....#...#...#...#.....#.#.#
#.#.#.#.#.###.#.#.###.#.#######.###.#.#######.###.#.###.#.#.#
#...#...#.#...#.#.#.#.#.#.....#...#.#.......#...#...#...#.#.#
#.#########.#####.#.#.#.#.###.#.#.###.#.#######.#####.###.#.#
#...#.....#.#.....#.#...#...#.#.#...#.#...#.....#...#.#.....#
###.#.###.#.#.#####.#######.#.#####.#.###.#.#######.#.###.###
#.#...#.#.#.......#.........#.......#.#...#.#.......#...#...#
#.#####.#.#######.#.#############.#####.###.#.#########.###.#
#...#.....#.....#...#...#.....#...#...#.....#.....#...#.#.#.#
###.#.#####.###.###.#.#.#.###.#####.#.#.#########.#.#.#.#.#.#
#...#.#.....#.....#.#.#.#.#.#...#...#.#...#.....#...#.#.#...#
#.###.#.###.#####.###.#.#.#.###.#.###.###.###.#.#####.#.###.#
#.#...#...#...#.#.....#.#.#.#...#...#.#.....#.#.......#...#.#
#.#.#####.###.#.#######.#.#.#.#####.#.#####.#.#######.###.#.#
#...#...#.#.#.#.........#.#...#.....#.....#...#...#.....#.#.#
#.###.#.#.#.#.#.#########.#.###.#########.#####.#.#.#####.###
#.....#.#...#.#.#.....#...#...#.....#.....#.....#...#...#...#
#######.#####.#.###.#.###.###.#.###.#.#####.#####.###.#.###.#
#.....#.#.....#...#.#.#...#.#.#...#.#...#...#...#...#.#.....#
###.#.#.#.#######.#.#.#.###.#.#####.###.#####.#.#####.#####.#
#...#.#...#.....#.#.#...#...#...#...#.#.......#.....#.....#.#
#.#########.#.#.#.#.#####.#.###.#.###.#############.#####.#.#
#.....#.....#.#.#.#...#.#.#.....#.#.........#.....#.....#.#.#
#.###.#.#####.###.###.#.#.#######.#.###.#####.#.#######.#.#.#
#...#.......#.........#...........#...#.......#...........#G#
#############################################################
