#########
#S#...#.#
#.#.#.#.#
#.#.#.#.#
#.#.#.#.#
#...#..G#
#########
