############################################################
#S............#.#..#.###..##..#.##..####.....#..##.#.#..#..#
#.#..##...#...#.##..#.#.#.#..##...#....#..#...#....#.......#
#.#.#.#..##..#.##.....#.#...#...###.#.....###....#........##
##.........##...............##......#...#.#..#..#.........##
#....#..#......##..#..#.#..#..###.........###.#.#..##.....##
###..##..##...###...#..#...#.#.###....#.....#.##....#.#..###
#...#...##....##......##......#.#..#..#..#...##.#...##..#.##
#...##.##..##.#..#....#..#.#....#..#.##.#....#..##.........#
#.#.#.....#..#.#.#.....###.##.#.#.#..##.#.##..#.#........###
##....#......#..##.#..#....#....#..#..........#....#.##..#.#
###..#....##.#.#...#..........##...#.....###.#.######...#..#
##..#.#...#..#...##.#.#..#...##...#..##.....##...###.......#
#.#......#.##.###..#.....#.##..#.....#.######.....#...##..##
#.............#.......##..##...#.#.......#.#.##...####.#..##
#####.....##.####..#.#.##.#.##..##...#...##..####.#.....#..#
#...###.##.#......##....#...#.#.##..#.##....#.#.##.....##..#
##....##.##..#.#.......#####.#.....###.#..#.##...#.#.#...###
#..#..#...###.####.....#..#.#...#.#.........##...#..#.##...#
##..###....##..#.#.#.#.#....##..#...........#.##..#..#.#...#
##........#.###..#.#....#....#..##....#..#..#......#..#....#
###....##.#..#..##....##....#.####.##.#...#......###...###.#
##.#....#.###.##.#.......####........#........#........#...#
#...#.......#.....#.#....#...#....#...........#..#.##..##..#
##.#..#.......#..#..#..#..###....#...#....####.......###...#
#...#..#....#...##.##.#.#..#..###.....#..#.#.#.####.....##.#
#......##..#....#..#.#..###.....#..#.#..#......##..#.####..#
#..#..#....#.#....#.##..##.#..#.......#..######..#...####..#
#.#.##....#.#..##...##.##.#.....#.#........##.##...###.#...#
##..##......#.#..#...##......#..###.##.##...#.#.#..#....#..#
#............#.#.#..#..##....##.#...####...#.#.....#.##...##
#...#....#..#...###......##..###.......##.#....#.#.....##..#
##....##..........##..##......#..########..##.......######.#
##..#.##..#.#.#..#.....###.#..###..##...........#..##...#..#
#.#..##...#...#..#.......##..........#.......#...#.#.##.#..#
##...#..#.#......#.##.....###.......#......#.####.......####
#.##....###.#.#..#....#.##.####..##....#...##.##....#..#.#.#
#...................#.......#...##.#.#.##.......#..........#
#.#....#......####.....#..#...#####..#..##.##.....#.##...###
#.........#..###....##.#..##..#....#....#.#..#..#.#...#....#
##..#.##.#.#...###....#...###...#.#.......#.#...##.##...#..#
#....#.###...#......#.##..#.......#.#.##.#..#..#...#....#..#
#.##..#.#.#.#.....####.##.#.#.....#####..#...#.#..#...#....#
####..#.#.##...#.....#...#....#.##...##.#.#..##.##.#.##.#..#
#..##....#.#....#.#..#.#...##....##..##.##.....#.....#...###
#..#..#...#..###..##.#.....##..#....###...#..#.#.#.......#.#
#..#..#.........#..#..#...#...#..#.##..##.#....##.......#.##
##...#....###.####.....##..#.....#..####...##..#..#....#.###
#.#...###.#.##.........#.#.#.#.#.##..###..#.#..####..#..##.#
#..#..#..####..###..###.##.#.#...##.#..#.#.#..#...#.#.#.##.#
#.###...#.##..#.#...#.#.....#....#..#.#.##.....##....#..##.#
##.###...#.##..#....#.##....##..#.....#####.#.#####.#.#....#
#..##..#.###.####..#.#.#...#...##....#.......#.............#
#...#.#........##....#........##.#...###.#......#..###..##.#
#.....#........##.#...............#..##..#...#...#..#.#.##.#
#.#.#..#.......#........##..........##..#..#............####
#.....##..#..#...#..#..#..#..#..#......#...#..###.#..#.....#
###..#....#.#...#..#.##.#...........#.......#.....#...#.#..#
##.##.......#..........#....#..##.........##..##.#..##.#..G#
############################################################
